8 7
SP.PP.P.
........
P......P
........
P......P
........
.P.PP.PR