........
........
.PPPPPP.
........
.PPPPPP.
........
.......R