........
........
...PP...
.P.PP.P.
...PP...
........
.......R