........
........
.P.PP.P.
........
.P.PP.P.
........
.......R